"a" = (/turf/template_noop,/area/template_noop)
"b" = (/turf/closed/wall/r_wall,/area/awaymission/undergroundoutpost45)
"c" = (/turf/open/floor/plating,/area/awaymission/undergroundoutpost45)
"d" = (/obj/structure/table,/obj/item/storage/toolbox/mechanical,/obj/item/stack/cable_coil,/obj/item/storage/box/lights/mixed,/turf/open/floor/plating,/area/awaymission/undergroundoutpost45)
"e" = (/obj/structure/table,/obj/item/clothing/mask/gas,/obj/machinery/light/small{dir = 1},/obj/item/clothing/glasses/sunglasses/big,/obj/item/clothing/glasses/sunglasses/big,/obj/item/clothing/glasses/sunglasses/big,/turf/open/floor/plating,/area/awaymission/undergroundoutpost45)
"f" = (/obj/structure/reagent_dispensers/fueltank,/turf/open/floor/plating,/area/awaymission/undergroundoutpost45)
"g" = (/obj/effect/mob_spawn/human/bartender/alive,/turf/open/floor/plating,/area/awaymission/undergroundoutpost45)
"h" = (/obj/machinery/portable_atmospherics/canister/oxygen,/turf/open/floor/plating,/area/awaymission/undergroundoutpost45)
"i" = (/obj/structure/toilet,/turf/open/floor/plating,/area/awaymission/undergroundoutpost45)
"j" = (/obj/structure/urinal{pixel_y = 32},/turf/open/floor/plating,/area/awaymission/undergroundoutpost45)
"k" = (/obj/structure/urinal{pixel_y = 32},/obj/effect/turf_decal/sand,/turf/open/floor/plating,/area/awaymission/undergroundoutpost45)
"l" = (/obj/item/flashlight/lantern,/obj/machinery/light/small{dir = 1},/turf/open/floor/plating,/area/awaymission/undergroundoutpost45)
"m" = (/obj/structure/sink{dir = 4; pixel_x = 11},/obj/effect/turf_decal/sand,/obj/structure/mirror{pixel_x = 28},/turf/open/floor/plating,/area/awaymission/undergroundoutpost45)
"n" = (/obj/structure/table,/obj/item/storage/box/drinkingglasses,/obj/item/storage/box/drinkingglasses,/obj/item/storage/box/beakers,/obj/item/storage/box/donkpockets,/turf/open/floor/plating,/area/awaymission/undergroundoutpost45)
"o" = (/obj/item/tank/internals/oxygen,/turf/open/floor/plating,/area/awaymission/undergroundoutpost45)
"p" = (/obj/effect/turf_decal/sand,/turf/open/floor/plating,/area/awaymission/undergroundoutpost45)
"q" = (/obj/machinery/light{dir = 4},/turf/open/floor/pod/dark{initial_gas_mix = "o2=14;n2=23;TEMP=300"},/area/awaymission/undergroundoutpost45)
"r" = (/obj/machinery/light{dir = 8},/turf/open/floor/pod/dark{initial_gas_mix = "o2=14;n2=23;TEMP=300"},/area/awaymission/undergroundoutpost45)
"s" = (/obj/structure/closet/athletic_mixed,/turf/open/floor/pod/dark,/area/awaymission/undergroundoutpost45)
"t" = (/obj/structure/rack,/obj/item/clothing/shoes/sandal,/obj/item/clothing/shoes/sandal,/obj/effect/turf_decal/sand,/turf/open/floor/pod/dark,/area/awaymission/undergroundoutpost45)
"u" = (/obj/effect/spawner/structure/window,/turf/open/floor/plating,/area/awaymission/undergroundoutpost45)
"v" = (/obj/structure/closet/athletic_mixed,/obj/effect/turf_decal/sand,/turf/open/floor/pod/dark,/area/awaymission/undergroundoutpost45)
"w" = (/obj/machinery/light/small{brightness = 3; dir = 8},/turf/open/floor/pod/dark,/area/awaymission/undergroundoutpost45)
"x" = (/turf/open/floor/pod/dark,/area/awaymission/undergroundoutpost45)
"y" = (/obj/effect/turf_decal/sand,/obj/machinery/light/small{dir = 4},/turf/open/floor/pod/dark,/area/awaymission/undergroundoutpost45)
"z" = (/obj/machinery/door/airlock/hatch{name = "Lava Beach Club"},/obj/structure/fans/tiny,/turf/open/floor/pod/dark,/area/awaymission/undergroundoutpost45)
"A" = (/turf/open/floor/pod/light,/area/awaymission/undergroundoutpost45)
"B" = (/obj/effect/turf_decal/sand,/turf/open/floor/pod/light,/area/awaymission/undergroundoutpost45)
"C" = (/obj/effect/turf_decal/sand,/obj/machinery/shower{dir = 4},/turf/open/floor/pod/light,/area/awaymission/undergroundoutpost45)
"D" = (/obj/machinery/door/airlock/Foundation,/turf/open/floor/pod/dark,/area/awaymission/undergroundoutpost45)
"E" = (/turf/open/water,/area/awaymission/undergroundoutpost45)
"F" = (/obj/machinery/shower{dir = 8},/turf/open/floor/pod/light,/area/awaymission/undergroundoutpost45)
"G" = (/obj/effect/turf_decal/sand,/obj/machinery/light/small{brightness = 3; dir = 8},/turf/open/floor/pod/dark,/area/awaymission/undergroundoutpost45)
"H" = (/obj/effect/turf_decal/sand,/turf/open/floor/pod/dark,/area/awaymission/undergroundoutpost45)
"I" = (/obj/machinery/light/small{dir = 4},/turf/open/floor/pod/dark,/area/awaymission/undergroundoutpost45)
"J" = (/obj/structure/table/wood,/obj/item/tank/internals/oxygen,/obj/item/pickaxe,/obj/item/clothing/mask/gas,/turf/open/floor/pod/dark,/area/awaymission/undergroundoutpost45)
"K" = (/obj/structure/dresser,/turf/open/floor/pod/dark,/area/awaymission/undergroundoutpost45)
"L" = (/turf/open/floor/circuit/red,/area/awaymission/undergroundoutpost45)
"M" = (/obj/machinery/doomsday_device{desc = "A tag on this device lables is as the on site warhead"},/turf/open/floor/circuit/red,/area/awaymission/undergroundoutpost45)

(1,1,1) = {"
aaaaaaaaaaaaaaaaaaaaaaaaaaaaaa
aaaaaabbbbbbbbbbbbbbbbbbaaaaaa
aaaabbbcbdefghcicjklmbcbbbaaaa
aaabbcccbncccocccccppbcccbbaaa
aabbccccbbcccccccccccbccccbbaa
aabccccccccccccccccccccccccbaa
abbccccccccccccccccccccccccbba
abccccccccccccccccccccccccccba
abccccccccccccccccccccccccccba
qbccccccccccccccccccccccccccbr
abccccccccccccccccccccccccccba
bbbbccccccccccccccccccccccbbbb
bstuccccccccccccccccccccccuvtb
bwxuccccccccccccccccccccccuxyb
zABuccccccccccccccccccccccuAAz
bCBDcccEccccccccccccccccccDBFb
zAAuccccccccccccccccccccccuBBz
bGxuccccccccccccccccccccccuHIb
bJKuccccccccccccccccccccccuKJb
bbbbccccccccccccccccccccccbbbb
abccccccccccccccccccccccccccba
qbccccccccccccccccccccccccccbr
abccccccccccccccccccccccccccba
abbccccccccccccccccccccccccbba
aabccccccccccccccccccccccccbaa
aabbccccccccccLLLcccccccccbbaa
aaabbcccccccccLMLccccccccbbaaa
aaaabbbcccccccLLLccccccbbbaaaa
aaaaaabbbbbbbbbbbbbbbbbbaaaaaa
aaaaaaaaaaaaaaaaaaaaaaaaaaaaaa
"}
